10000000
00000000
00010000
00000000
00000100
00000000
23001000